[	milton-paradise.txt
Paradise	milton-paradise.txt
Lost	milton-paradise.txt
by	milton-paradise.txt
John	milton-paradise.txt
Milton	milton-paradise.txt
1667	milton-paradise.txt
]	milton-paradise.txt
Book	milton-paradise.txt
I	milton-paradise.txt
Of	milton-paradise.txt
Man	milton-paradise.txt
'	milton-paradise.txt
s	milton-paradise.txt
first	milton-paradise.txt
disobedience	milton-paradise.txt
,	milton-paradise.txt
and	milton-paradise.txt
the	milton-paradise.txt
fruit	milton-paradise.txt
that	milton-paradise.txt
forbidden	milton-paradise.txt
tree	milton-paradise.txt
whose	milton-paradise.txt
mortal	milton-paradise.txt
taste	milton-paradise.txt
Brought	milton-paradise.txt
death	milton-paradise.txt
into	milton-paradise.txt
World	milton-paradise.txt
all	milton-paradise.txt
our	milton-paradise.txt
woe	milton-paradise.txt
With	milton-paradise.txt
loss	milton-paradise.txt
of	milton-paradise.txt
Eden	milton-paradise.txt
till	milton-paradise.txt
one	milton-paradise.txt
greater	milton-paradise.txt
Restore	milton-paradise.txt
us	milton-paradise.txt
regain	milton-paradise.txt
blissful	milton-paradise.txt
seat	milton-paradise.txt
Sing	milton-paradise.txt
Heavenly	milton-paradise.txt
Muse	milton-paradise.txt
on	milton-paradise.txt
secret	milton-paradise.txt
top	milton-paradise.txt
Oreb	milton-paradise.txt
or	milton-paradise.txt
Sinai	milton-paradise.txt
didst	milton-paradise.txt
inspire	milton-paradise.txt
That	milton-paradise.txt
shepherd	milton-paradise.txt
who	milton-paradise.txt
taught	milton-paradise.txt
chosen	milton-paradise.txt
seed	milton-paradise.txt
In	milton-paradise.txt
beginning	milton-paradise.txt
how	milton-paradise.txt
heavens	milton-paradise.txt
earth	milton-paradise.txt
Rose	milton-paradise.txt
out	milton-paradise.txt
Chaos	milton-paradise.txt
:	milton-paradise.txt
if	milton-paradise.txt
Sion	milton-paradise.txt
hill	milton-paradise.txt
Delight	milton-paradise.txt
thee	milton-paradise.txt
more	milton-paradise.txt
Siloa	milton-paradise.txt
brook	milton-paradise.txt
flowed	milton-paradise.txt
Fast	milton-paradise.txt
oracle	milton-paradise.txt
God	milton-paradise.txt
thence	milton-paradise.txt
Invoke	milton-paradise.txt
thy	milton-paradise.txt
aid	milton-paradise.txt
to	milton-paradise.txt
my	milton-paradise.txt
adventurous	milton-paradise.txt
song	milton-paradise.txt
with	milton-paradise.txt
no	milton-paradise.txt
middle	milton-paradise.txt
flight	milton-paradise.txt
intends	milton-paradise.txt
soar	milton-paradise.txt
Above	milton-paradise.txt
th	milton-paradise.txt
Aonian	milton-paradise.txt
mount	milton-paradise.txt
while	milton-paradise.txt
it	milton-paradise.txt
pursues	milton-paradise.txt
Things	milton-paradise.txt
unattempted	milton-paradise.txt
yet	milton-paradise.txt
in	milton-paradise.txt
prose	milton-paradise.txt
rhyme	milton-paradise.txt
.	milton-paradise.txt
[	edgeworth-parents.txt
The	edgeworth-parents.txt
Parent	edgeworth-parents.txt
'	edgeworth-parents.txt
s	edgeworth-parents.txt
Assistant	edgeworth-parents.txt
,	edgeworth-parents.txt
by	edgeworth-parents.txt
Maria	edgeworth-parents.txt
Edgeworth	edgeworth-parents.txt
]	edgeworth-parents.txt
THE	edgeworth-parents.txt
ORPHANS	edgeworth-parents.txt
.	edgeworth-parents.txt
Near	edgeworth-parents.txt
the	edgeworth-parents.txt
ruins	edgeworth-parents.txt
of	edgeworth-parents.txt
castle	edgeworth-parents.txt
Rossmore	edgeworth-parents.txt
in	edgeworth-parents.txt
Ireland	edgeworth-parents.txt
is	edgeworth-parents.txt
a	edgeworth-parents.txt
small	edgeworth-parents.txt
cabin	edgeworth-parents.txt
which	edgeworth-parents.txt
there	edgeworth-parents.txt
once	edgeworth-parents.txt
lived	edgeworth-parents.txt
widow	edgeworth-parents.txt
and	edgeworth-parents.txt
her	edgeworth-parents.txt
four	edgeworth-parents.txt
children	edgeworth-parents.txt
As	edgeworth-parents.txt
long	edgeworth-parents.txt
as	edgeworth-parents.txt
she	edgeworth-parents.txt
was	edgeworth-parents.txt
able	edgeworth-parents.txt
to	edgeworth-parents.txt
work	edgeworth-parents.txt
very	edgeworth-parents.txt
industrious	edgeworth-parents.txt
accounted	edgeworth-parents.txt
best	edgeworth-parents.txt
spinner	edgeworth-parents.txt
parish	edgeworth-parents.txt
;	edgeworth-parents.txt
but	edgeworth-parents.txt
overworked	edgeworth-parents.txt
herself	edgeworth-parents.txt
at	edgeworth-parents.txt
last	edgeworth-parents.txt
fell	edgeworth-parents.txt
ill	edgeworth-parents.txt
so	edgeworth-parents.txt
that	edgeworth-parents.txt
could	edgeworth-parents.txt
not	edgeworth-parents.txt
sit	edgeworth-parents.txt
wheel	edgeworth-parents.txt
used	edgeworth-parents.txt
do	edgeworth-parents.txt
obliged	edgeworth-parents.txt
give	edgeworth-parents.txt
it	edgeworth-parents.txt
up	edgeworth-parents.txt
eldest	edgeworth-parents.txt
daughter	edgeworth-parents.txt
Mary	edgeworth-parents.txt
[	austen-emma.txt
Emma	austen-emma.txt
by	austen-emma.txt
Jane	austen-emma.txt
Austen	austen-emma.txt
1816	austen-emma.txt
]	austen-emma.txt
VOLUME	austen-emma.txt
I	austen-emma.txt
CHAPTER	austen-emma.txt
Woodhouse	austen-emma.txt
,	austen-emma.txt
handsome	austen-emma.txt
clever	austen-emma.txt
and	austen-emma.txt
rich	austen-emma.txt
with	austen-emma.txt
a	austen-emma.txt
comfortable	austen-emma.txt
home	austen-emma.txt
happy	austen-emma.txt
disposition	austen-emma.txt
seemed	austen-emma.txt
to	austen-emma.txt
unite	austen-emma.txt
some	austen-emma.txt
of	austen-emma.txt
the	austen-emma.txt
best	austen-emma.txt
blessings	austen-emma.txt
existence	austen-emma.txt
;	austen-emma.txt
had	austen-emma.txt
lived	austen-emma.txt
nearly	austen-emma.txt
twenty	austen-emma.txt
-	austen-emma.txt
one	austen-emma.txt
years	austen-emma.txt
in	austen-emma.txt
world	austen-emma.txt
very	austen-emma.txt
little	austen-emma.txt
distress	austen-emma.txt
or	austen-emma.txt
vex	austen-emma.txt
her	austen-emma.txt
.	austen-emma.txt
She	austen-emma.txt
was	austen-emma.txt
youngest	austen-emma.txt
two	austen-emma.txt
daughters	austen-emma.txt
most	austen-emma.txt
affectionate	austen-emma.txt
indulgent	austen-emma.txt
father	austen-emma.txt
consequence	austen-emma.txt
sister	austen-emma.txt
'	austen-emma.txt
s	austen-emma.txt
marriage	austen-emma.txt
been	austen-emma.txt
mistress	austen-emma.txt
his	austen-emma.txt
house	austen-emma.txt
from	austen-emma.txt
early	austen-emma.txt
period	austen-emma.txt
Her	austen-emma.txt
mother	austen-emma.txt
died	austen-emma.txt
too	austen-emma.txt
long	austen-emma.txt
ago	austen-emma.txt
for	austen-emma.txt
have	austen-emma.txt
more	austen-emma.txt
than	austen-emma.txt
an	austen-emma.txt
indistinct	austen-emma.txt
remembrance	austen-emma.txt
caresses	austen-emma.txt
place	austen-emma.txt
supplied	austen-emma.txt
excellent	austen-emma.txt
woman	austen-emma.txt
as	austen-emma.txt
governess	austen-emma.txt
who	austen-emma.txt
fallen	austen-emma.txt
short	austen-emma.txt
affection	austen-emma.txt
[	chesterton-ball.txt
The	chesterton-ball.txt
Ball	chesterton-ball.txt
and	chesterton-ball.txt
Cross	chesterton-ball.txt
by	chesterton-ball.txt
G	chesterton-ball.txt
.	chesterton-ball.txt
K	chesterton-ball.txt
Chesterton	chesterton-ball.txt
1909	chesterton-ball.txt
]	chesterton-ball.txt
I	chesterton-ball.txt
A	chesterton-ball.txt
DISCUSSION	chesterton-ball.txt
SOMEWHAT	chesterton-ball.txt
IN	chesterton-ball.txt
THE	chesterton-ball.txt
AIR	chesterton-ball.txt
flying	chesterton-ball.txt
ship	chesterton-ball.txt
of	chesterton-ball.txt
Professor	chesterton-ball.txt
Lucifer	chesterton-ball.txt
sang	chesterton-ball.txt
through	chesterton-ball.txt
the	chesterton-ball.txt
skies	chesterton-ball.txt
like	chesterton-ball.txt
a	chesterton-ball.txt
silver	chesterton-ball.txt
arrow	chesterton-ball.txt
;	chesterton-ball.txt
bleak	chesterton-ball.txt
white	chesterton-ball.txt
steel	chesterton-ball.txt
it	chesterton-ball.txt
,	chesterton-ball.txt
gleaming	chesterton-ball.txt
in	chesterton-ball.txt
blue	chesterton-ball.txt
emptiness	chesterton-ball.txt
evening	chesterton-ball.txt
That	chesterton-ball.txt
was	chesterton-ball.txt
far	chesterton-ball.txt
above	chesterton-ball.txt
earth	chesterton-ball.txt
no	chesterton-ball.txt
expression	chesterton-ball.txt
for	chesterton-ball.txt
to	chesterton-ball.txt
two	chesterton-ball.txt
men	chesterton-ball.txt
seemed	chesterton-ball.txt
be	chesterton-ball.txt
stars	chesterton-ball.txt
professor	chesterton-ball.txt
had	chesterton-ball.txt
himself	chesterton-ball.txt
invented	chesterton-ball.txt
machine	chesterton-ball.txt
also	chesterton-ball.txt
nearly	chesterton-ball.txt
everything	chesterton-ball.txt
[	bible-kjv.txt
The	bible-kjv.txt
King	bible-kjv.txt
James	bible-kjv.txt
Bible	bible-kjv.txt
]	bible-kjv.txt
Old	bible-kjv.txt
Testament	bible-kjv.txt
of	bible-kjv.txt
the	bible-kjv.txt
First	bible-kjv.txt
Book	bible-kjv.txt
Moses	bible-kjv.txt
:	bible-kjv.txt
Called	bible-kjv.txt
Genesis	bible-kjv.txt
1	bible-kjv.txt
In	bible-kjv.txt
beginning	bible-kjv.txt
God	bible-kjv.txt
created	bible-kjv.txt
heaven	bible-kjv.txt
and	bible-kjv.txt
earth	bible-kjv.txt
.	bible-kjv.txt
2	bible-kjv.txt
And	bible-kjv.txt
was	bible-kjv.txt
without	bible-kjv.txt
form	bible-kjv.txt
,	bible-kjv.txt
void	bible-kjv.txt
;	bible-kjv.txt
darkness	bible-kjv.txt
upon	bible-kjv.txt
face	bible-kjv.txt
deep	bible-kjv.txt
Spirit	bible-kjv.txt
moved	bible-kjv.txt
waters	bible-kjv.txt
3	bible-kjv.txt
said	bible-kjv.txt
Let	bible-kjv.txt
there	bible-kjv.txt
be	bible-kjv.txt
light	bible-kjv.txt
4	bible-kjv.txt
saw	bible-kjv.txt
that	bible-kjv.txt
it	bible-kjv.txt
good	bible-kjv.txt
divided	bible-kjv.txt
from	bible-kjv.txt
5	bible-kjv.txt
called	bible-kjv.txt
Day	bible-kjv.txt
he	bible-kjv.txt
Night	bible-kjv.txt
evening	bible-kjv.txt
morning	bible-kjv.txt
were	bible-kjv.txt
first	bible-kjv.txt
day	bible-kjv.txt
[	chesterton-thursday.txt
The	chesterton-thursday.txt
Man	chesterton-thursday.txt
Who	chesterton-thursday.txt
Was	chesterton-thursday.txt
Thursday	chesterton-thursday.txt
by	chesterton-thursday.txt
G	chesterton-thursday.txt
.	chesterton-thursday.txt
K	chesterton-thursday.txt
Chesterton	chesterton-thursday.txt
1908	chesterton-thursday.txt
]	chesterton-thursday.txt
To	chesterton-thursday.txt
Edmund	chesterton-thursday.txt
Clerihew	chesterton-thursday.txt
Bentley	chesterton-thursday.txt
A	chesterton-thursday.txt
cloud	chesterton-thursday.txt
was	chesterton-thursday.txt
on	chesterton-thursday.txt
the	chesterton-thursday.txt
mind	chesterton-thursday.txt
of	chesterton-thursday.txt
men	chesterton-thursday.txt
,	chesterton-thursday.txt
and	chesterton-thursday.txt
wailing	chesterton-thursday.txt
went	chesterton-thursday.txt
weather	chesterton-thursday.txt
Yea	chesterton-thursday.txt
a	chesterton-thursday.txt
sick	chesterton-thursday.txt
upon	chesterton-thursday.txt
soul	chesterton-thursday.txt
when	chesterton-thursday.txt
we	chesterton-thursday.txt
were	chesterton-thursday.txt
boys	chesterton-thursday.txt
together	chesterton-thursday.txt
Science	chesterton-thursday.txt
announced	chesterton-thursday.txt
nonentity	chesterton-thursday.txt
art	chesterton-thursday.txt
admired	chesterton-thursday.txt
decay	chesterton-thursday.txt
;	chesterton-thursday.txt
world	chesterton-thursday.txt
old	chesterton-thursday.txt
ended	chesterton-thursday.txt
:	chesterton-thursday.txt
but	chesterton-thursday.txt
you	chesterton-thursday.txt
I	chesterton-thursday.txt
gay	chesterton-thursday.txt
Round	chesterton-thursday.txt
us	chesterton-thursday.txt
in	chesterton-thursday.txt
antic	chesterton-thursday.txt
order	chesterton-thursday.txt
their	chesterton-thursday.txt
crippled	chesterton-thursday.txt
vices	chesterton-thursday.txt
came	chesterton-thursday.txt
--	chesterton-thursday.txt
Lust	chesterton-thursday.txt
that	chesterton-thursday.txt
had	chesterton-thursday.txt
lost	chesterton-thursday.txt
its	chesterton-thursday.txt
laughter	chesterton-thursday.txt
fear	chesterton-thursday.txt
shame	chesterton-thursday.txt
Like	chesterton-thursday.txt
white	chesterton-thursday.txt
lock	chesterton-thursday.txt
Whistler	chesterton-thursday.txt
lit	chesterton-thursday.txt
our	chesterton-thursday.txt
aimless	chesterton-thursday.txt
gloom	chesterton-thursday.txt
Men	chesterton-thursday.txt
showed	chesterton-thursday.txt
own	chesterton-thursday.txt
feather	chesterton-thursday.txt
as	chesterton-thursday.txt
proudly	chesterton-thursday.txt
plume	chesterton-thursday.txt
Life	chesterton-thursday.txt
fly	chesterton-thursday.txt
faded	chesterton-thursday.txt
death	chesterton-thursday.txt
drone	chesterton-thursday.txt
stung	chesterton-thursday.txt
very	chesterton-thursday.txt
indeed	chesterton-thursday.txt
young	chesterton-thursday.txt
[	blake-poems.txt
Poems	blake-poems.txt
by	blake-poems.txt
William	blake-poems.txt
Blake	blake-poems.txt
1789	blake-poems.txt
]	blake-poems.txt
SONGS	blake-poems.txt
OF	blake-poems.txt
INNOCENCE	blake-poems.txt
AND	blake-poems.txt
EXPERIENCE	blake-poems.txt
and	blake-poems.txt
THE	blake-poems.txt
BOOK	blake-poems.txt
of	blake-poems.txt
THEL	blake-poems.txt
INTRODUCTION	blake-poems.txt
Piping	blake-poems.txt
down	blake-poems.txt
the	blake-poems.txt
valleys	blake-poems.txt
wild	blake-poems.txt
,	blake-poems.txt
songs	blake-poems.txt
pleasant	blake-poems.txt
glee	blake-poems.txt
On	blake-poems.txt
a	blake-poems.txt
cloud	blake-poems.txt
I	blake-poems.txt
saw	blake-poems.txt
child	blake-poems.txt
And	blake-poems.txt
he	blake-poems.txt
laughing	blake-poems.txt
said	blake-poems.txt
to	blake-poems.txt
me	blake-poems.txt
:	blake-poems.txt
"	blake-poems.txt
Pipe	blake-poems.txt
song	blake-poems.txt
about	blake-poems.txt
Lamb	blake-poems.txt
!"	blake-poems.txt
So	blake-poems.txt
piped	blake-poems.txt
with	blake-poems.txt
merry	blake-poems.txt
cheer	blake-poems.txt
.	blake-poems.txt
Piper	blake-poems.txt
pipe	blake-poems.txt
that	blake-poems.txt
again	blake-poems.txt
;"	blake-poems.txt
wept	blake-poems.txt
hear	blake-poems.txt
Drop	blake-poems.txt
thy	blake-poems.txt
happy	blake-poems.txt
;	blake-poems.txt
Sing	blake-poems.txt
:!"	blake-poems.txt
sang	blake-poems.txt
same	blake-poems.txt
While	blake-poems.txt
joy	blake-poems.txt
sit	blake-poems.txt
thee	blake-poems.txt
write	blake-poems.txt
In	blake-poems.txt
book	blake-poems.txt
all	blake-poems.txt
may	blake-poems.txt
read	blake-poems.txt
."	blake-poems.txt
vanish	blake-poems.txt
'	blake-poems.txt
d	blake-poems.txt
from	blake-poems.txt
my	blake-poems.txt
sight	blake-poems.txt
pluck	blake-poems.txt
hollow	blake-poems.txt
reed	blake-poems.txt
made	blake-poems.txt
rural	blake-poems.txt
pen	blake-poems.txt
stain	blake-poems.txt
water	blake-poems.txt
clear	blake-poems.txt
wrote	blake-poems.txt
Every	blake-poems.txt
[	shakespeare-caesar.txt
The	shakespeare-caesar.txt
Tragedie	shakespeare-caesar.txt
of	shakespeare-caesar.txt
Julius	shakespeare-caesar.txt
Caesar	shakespeare-caesar.txt
by	shakespeare-caesar.txt
William	shakespeare-caesar.txt
Shakespeare	shakespeare-caesar.txt
1599	shakespeare-caesar.txt
]	shakespeare-caesar.txt
Actus	shakespeare-caesar.txt
Primus	shakespeare-caesar.txt
.	shakespeare-caesar.txt
Scoena	shakespeare-caesar.txt
Prima	shakespeare-caesar.txt
Enter	shakespeare-caesar.txt
Flauius	shakespeare-caesar.txt
,	shakespeare-caesar.txt
Murellus	shakespeare-caesar.txt
and	shakespeare-caesar.txt
certaine	shakespeare-caesar.txt
Commoners	shakespeare-caesar.txt
ouer	shakespeare-caesar.txt
the	shakespeare-caesar.txt
Stage	shakespeare-caesar.txt
Hence	shakespeare-caesar.txt
:	shakespeare-caesar.txt
home	shakespeare-caesar.txt
you	shakespeare-caesar.txt
idle	shakespeare-caesar.txt
Creatures	shakespeare-caesar.txt
get	shakespeare-caesar.txt
Is	shakespeare-caesar.txt
this	shakespeare-caesar.txt
a	shakespeare-caesar.txt
Holiday	shakespeare-caesar.txt
?	shakespeare-caesar.txt
What	shakespeare-caesar.txt
know	shakespeare-caesar.txt
not	shakespeare-caesar.txt
(	shakespeare-caesar.txt
Being	shakespeare-caesar.txt
Mechanicall	shakespeare-caesar.txt
)	shakespeare-caesar.txt
ought	shakespeare-caesar.txt
walke	shakespeare-caesar.txt
Vpon	shakespeare-caesar.txt
labouring	shakespeare-caesar.txt
day	shakespeare-caesar.txt
without	shakespeare-caesar.txt
signe	shakespeare-caesar.txt
Of	shakespeare-caesar.txt
your	shakespeare-caesar.txt
Profession	shakespeare-caesar.txt
Speake	shakespeare-caesar.txt
what	shakespeare-caesar.txt
Trade	shakespeare-caesar.txt
art	shakespeare-caesar.txt
thou	shakespeare-caesar.txt
Car	shakespeare-caesar.txt
Why	shakespeare-caesar.txt
Sir	shakespeare-caesar.txt
Carpenter	shakespeare-caesar.txt
Mur	shakespeare-caesar.txt
Where	shakespeare-caesar.txt
is	shakespeare-caesar.txt
thy	shakespeare-caesar.txt
Leather	shakespeare-caesar.txt
Apron	shakespeare-caesar.txt
Rule	shakespeare-caesar.txt
dost	shakespeare-caesar.txt
with	shakespeare-caesar.txt
best	shakespeare-caesar.txt
Apparrell	shakespeare-caesar.txt
on	shakespeare-caesar.txt
You	shakespeare-caesar.txt
sir	shakespeare-caesar.txt
are	shakespeare-caesar.txt
Cobl	shakespeare-caesar.txt
Truely	shakespeare-caesar.txt
in	shakespeare-caesar.txt
respect	shakespeare-caesar.txt
fine	shakespeare-caesar.txt
Workman	shakespeare-caesar.txt
I	shakespeare-caesar.txt
am	shakespeare-caesar.txt
but	shakespeare-caesar.txt
as	shakespeare-caesar.txt
would	shakespeare-caesar.txt
say	shakespeare-caesar.txt
Cobler	shakespeare-caesar.txt
But	shakespeare-caesar.txt
Answer	shakespeare-caesar.txt
me	shakespeare-caesar.txt
directly	shakespeare-caesar.txt
Cob	shakespeare-caesar.txt
A	shakespeare-caesar.txt
that	shakespeare-caesar.txt
hope	shakespeare-caesar.txt
may	shakespeare-caesar.txt
vse	shakespeare-caesar.txt
safe	shakespeare-caesar.txt
Conscience	shakespeare-caesar.txt
which	shakespeare-caesar.txt
indeed	shakespeare-caesar.txt
Mender	shakespeare-caesar.txt
bad	shakespeare-caesar.txt
soules	shakespeare-caesar.txt
Fla	shakespeare-caesar.txt
[	whitman-leaves.txt
Leaves	whitman-leaves.txt
of	whitman-leaves.txt
Grass	whitman-leaves.txt
by	whitman-leaves.txt
Walt	whitman-leaves.txt
Whitman	whitman-leaves.txt
1855	whitman-leaves.txt
]	whitman-leaves.txt
Come	whitman-leaves.txt
,	whitman-leaves.txt
said	whitman-leaves.txt
my	whitman-leaves.txt
soul	whitman-leaves.txt
Such	whitman-leaves.txt
verses	whitman-leaves.txt
for	whitman-leaves.txt
Body	whitman-leaves.txt
let	whitman-leaves.txt
us	whitman-leaves.txt
write	whitman-leaves.txt
(	whitman-leaves.txt
we	whitman-leaves.txt
are	whitman-leaves.txt
one	whitman-leaves.txt
,)	whitman-leaves.txt
That	whitman-leaves.txt
should	whitman-leaves.txt
I	whitman-leaves.txt
after	whitman-leaves.txt
return	whitman-leaves.txt
Or	whitman-leaves.txt
long	whitman-leaves.txt
hence	whitman-leaves.txt
in	whitman-leaves.txt
other	whitman-leaves.txt
spheres	whitman-leaves.txt
There	whitman-leaves.txt
to	whitman-leaves.txt
some	whitman-leaves.txt
group	whitman-leaves.txt
mates	whitman-leaves.txt
the	whitman-leaves.txt
chants	whitman-leaves.txt
resuming	whitman-leaves.txt
Tallying	whitman-leaves.txt
Earth	whitman-leaves.txt
'	whitman-leaves.txt
s	whitman-leaves.txt
soil	whitman-leaves.txt
trees	whitman-leaves.txt
winds	whitman-leaves.txt
tumultuous	whitman-leaves.txt
waves	whitman-leaves.txt
Ever	whitman-leaves.txt
with	whitman-leaves.txt
pleas	whitman-leaves.txt
d	whitman-leaves.txt
smile	whitman-leaves.txt
may	whitman-leaves.txt
keep	whitman-leaves.txt
on	whitman-leaves.txt
and	whitman-leaves.txt
ever	whitman-leaves.txt
yet	whitman-leaves.txt
owning	whitman-leaves.txt
--	whitman-leaves.txt
as	whitman-leaves.txt
first	whitman-leaves.txt
here	whitman-leaves.txt
now	whitman-leaves.txt
Signing	whitman-leaves.txt
Soul	whitman-leaves.txt
set	whitman-leaves.txt
them	whitman-leaves.txt
name	whitman-leaves.txt
BOOK	whitman-leaves.txt
.	whitman-leaves.txt
INSCRIPTIONS	whitman-leaves.txt
}	whitman-leaves.txt
One	whitman-leaves.txt
-	whitman-leaves.txt
Self	whitman-leaves.txt
Sing	whitman-leaves.txt
self	whitman-leaves.txt
sing	whitman-leaves.txt
a	whitman-leaves.txt
simple	whitman-leaves.txt
separate	whitman-leaves.txt
person	whitman-leaves.txt
Yet	whitman-leaves.txt
utter	whitman-leaves.txt
word	whitman-leaves.txt
Democratic	whitman-leaves.txt
En	whitman-leaves.txt
Masse	whitman-leaves.txt
[	melville-moby_dick.txt
Moby	melville-moby_dick.txt
Dick	melville-moby_dick.txt
by	melville-moby_dick.txt
Herman	melville-moby_dick.txt
Melville	melville-moby_dick.txt
1851	melville-moby_dick.txt
]	melville-moby_dick.txt
ETYMOLOGY	melville-moby_dick.txt
.	melville-moby_dick.txt
(	melville-moby_dick.txt
Supplied	melville-moby_dick.txt
a	melville-moby_dick.txt
Late	melville-moby_dick.txt
Consumptive	melville-moby_dick.txt
Usher	melville-moby_dick.txt
to	melville-moby_dick.txt
Grammar	melville-moby_dick.txt
School	melville-moby_dick.txt
)	melville-moby_dick.txt
The	melville-moby_dick.txt
pale	melville-moby_dick.txt
--	melville-moby_dick.txt
threadbare	melville-moby_dick.txt
in	melville-moby_dick.txt
coat	melville-moby_dick.txt
,	melville-moby_dick.txt
heart	melville-moby_dick.txt
body	melville-moby_dick.txt
and	melville-moby_dick.txt
brain	melville-moby_dick.txt
;	melville-moby_dick.txt
I	melville-moby_dick.txt
see	melville-moby_dick.txt
him	melville-moby_dick.txt
now	melville-moby_dick.txt
He	melville-moby_dick.txt
was	melville-moby_dick.txt
ever	melville-moby_dick.txt
dusting	melville-moby_dick.txt
his	melville-moby_dick.txt
old	melville-moby_dick.txt
lexicons	melville-moby_dick.txt
grammars	melville-moby_dick.txt
with	melville-moby_dick.txt
queer	melville-moby_dick.txt
handkerchief	melville-moby_dick.txt
mockingly	melville-moby_dick.txt
embellished	melville-moby_dick.txt
all	melville-moby_dick.txt
the	melville-moby_dick.txt
gay	melville-moby_dick.txt
flags	melville-moby_dick.txt
of	melville-moby_dick.txt
known	melville-moby_dick.txt
nations	melville-moby_dick.txt
world	melville-moby_dick.txt
loved	melville-moby_dick.txt
dust	melville-moby_dick.txt
it	melville-moby_dick.txt
somehow	melville-moby_dick.txt
mildly	melville-moby_dick.txt
reminded	melville-moby_dick.txt
mortality	melville-moby_dick.txt
